用户问句	名词短语
缩倍量阴是什么情况	缩倍量阴
缩量高换手是什么意思	缩量高换手
缩量和放量是什么意思	量和放量
缩量十字星说明什么	缩量十字星
缩量涨停意义	缩量
所属概念包含叶飞	所属概念_|_叶飞
所属概念包括叶飞概念	所属概念包括_|_叶飞概念
所属叶飞概念股	叶飞概念股
所属昨日竞价异动看多板块	板块
所谓的机构席位是什么意思	机构席位
所以人家说要开股东大会吗	股东大会
所有股票异动语音播报提醒	股票异动语音播报提醒
所有者权益代表什么	者权益
所有者权益合计是啥意思	者权益合计
索菲亚今天有庄家出货吗	索菲亚_|_庄家
索菱机构席位卖出金额	索菱机构席位_|_金额
他是不是庄股	庄股
他是庄股	庄股
他是庄股还是机构	庄股_|_机构
他是庄股吗？	庄股
他是庄股嘛！	庄股
他有几家上市公司	上市公司
他庄股了他	他庄股
它是庄股	庄股
它是庄股吗？	庄股
它是庄股票吗	庄股
塔牌集团孙公司	塔牌集团孙公司
踏空是什么意思	踏空
台基股份简介	台基股份
太极股份私募调研次数明细	太极股份_|_私募调研次数
太平鸟为何被港股通剔除	太平鸟_|_港股通
太平洋庄家盈亏	太平洋_|_庄家盈亏
太阳能000591庄家洗盘结束	太阳能_|_庄家
泰达股份量价异动	泰达股份_|_量价异动
泰晶科技异动提醒	泰晶科技异动提醒
泰永长征是庄股把	泰永长征_|_庄股
谭政	谭政
碳中和 碳达峰	 碳达峰
碳中和的意义	碳中和
唐球	唐球
唐狮	唐狮
唐晓斌	唐晓斌
唐颖	唐颖
特变电工：庄家是否在洗盘	特变电工_|_庄家
特拉斯的一级供应商有哪些上市公司	特拉斯_|_上市公司
特斯拉产业链相关上市公司有哪些	特斯拉产业链_|_上市公司
特斯拉供应链有哪些上市公司	特斯拉供应链_|_上市公司
特斯拉供应商上市公司有哪些	特斯拉供应商_|_上市公司
特斯拉一级供应商的上市公司有哪些	特斯拉一级供应商_|_上市公司
特斯拉一级供应商上市公司有哪些	特斯拉一级供应商_|_上市公司
腾邦格科	腾邦格科
腾湘	腾湘
腾讯参股的上市公司有哪些	腾讯_|_上市公司
腾讯音乐的股东和合作伙伴都有哪些上市公司	腾讯音乐_|_股东_|_上市公司
滕用雄	滕用雄
剔除叶飞概念股票	叶飞概念股票
天邦股份股权激励的股票来源	天邦股份_|_股票来源
天赐材料财报图解	天赐材料财报图解
天赐材料公司基本信息	天赐材料公司基本信息
天赐材料这家公司主要是做什么业务的	天赐材料这家公司
天地科技庄股票成本	天地科技_|_股票成本
天风证券研报评级的股票	天风证券_|_研报评级_|_股票
天风证券研报评级买入或增持的股票	天风证券_|_研报评级_|_股票
天广中茂庄家有没出货	天广中茂_|_庄家
天海防务停牌是利好还是看	天海防务
天津北清远东股份有限公司	天津北清远东股份有限公司
天津大学是股东的上市公司有哪些	天津大学_|_股东_|_上市公司
天津哪个区上市公司多	天津_|_上市公司
天津松江庄家砸盘	天津松江_|_庄家
天龙集团这两天的异动是什么原因	天龙集团_|_异动
天能是庄家控制的股票吗？还是庄家操作股票。	天能_|_庄家_|_股票
天汽模今天庄家是在出货还是在洗盘	天汽模_|_庄家
天汽模庄家盈亏	天汽模_|_庄家盈亏
天桥起重庄家拉升的套路	天桥起重_|_庄家
天然纯碱	天然纯碱
天山生物是不是庄家出逃	天山生物_|_庄家
天山生物是不是庄家出逃了	天山生物_|_庄家
天山生物天山生物有机构席位	天山生物天山生物_|_机构席位
天山生物停牌几	天山生物
天味食品的庄家是在洗盘嘛	天味食品_|_庄家
天夏还有庄家持股吗	天夏_|_庄家持股
天夏智慧庄家出货没	天夏智慧_|_庄家
天音控股是洗盘还是庄家跑	天音控股_|_庄家
天银机电，庄家像洗盘吗？	天银机电_|_庄家
天银机电近一个月是否庄家出货	天银机电_|_庄家
天永智能散户多还是庄家多	天永智能_|_散户_|_庄家
天元股份有庄家吗	天元股份_|_庄家
天舟文化股票激励期权行权	天舟文化_|_股票激励期权行权
田泽训	田泽训
田中精机的股票激励计划是利好还是利空	田中精机_|_股票激励计划
挑选可以买入的港股通	挑选_|_港股通
调研报告最多的行业	调研报告_|_行业
调研公告海天味业业	调研公告_|_海天味业业
调研公告日期(券商)近5天	调研公告日期(券商
调研公告日期(私募)近5天	调研公告日期(私募
调研公告日期(私募)为近3天	调研公告日期(私募
调研活动是利好还是利空	调研活动
调研机构包含高瓴和高毅2020	调研机构_|_高瓴_|_高毅
调研机构名称包含高瓴最近一年	调研机构_|_高瓴
调研机构是高瓴2020调研机构是高毅	调研机构_|_高瓴_|_调研机构_|_高毅
调研机构是高瓴和高毅2020	调研机构_|_高瓴_|_高毅
调研机构最多买入的股票	调研机构_|_股票
调研人员职位包含所长或首席或者组长或者总监或者基金经理	调研人员职位_|_首席_|_总监_|_基金经理
调研私募名称什么意思	私募名称
调研私募什么意思	调研私募
调研最多的股票社保基金406	股票社保基金
跳开收阴代表什么意思	跳开收阴
跳空高开墓碑线代表	跳空高开墓碑线
跳空高开墓碑线代表什么	跳空高开墓碑线
跳空阴k线是什么意思	跳空阴k线
铁龙物流的奉献	铁龙物流_|_奉献
停牌2021.1.1~2021.03.30股票异常波动停牌	
停牌的的新股	新股
停牌的条件	停牌的条件
停牌的新股	新股
停牌的妖股	妖股
停牌多年后复牌的股票	
停牌二年多的股票	股票
停牌复牌概念	停牌复牌概念
停牌复牌公告	停牌复牌公告
停牌核查的股票	股票
停牌后复牌无涨跌幅	
停牌几日复牌无涨跌幅限制	复牌无涨跌幅限制
停牌期限2220191202*停牌期限20191129	停牌期限_|_停牌期限
停牌期限是10月18日以来	停牌期限
停牌期限是自10月18日起	停牌期限
停牌期限是自10月起	停牌期限
停牌日期超过30天	停牌日期
停牌日期是今日且复牌日期是今日	停牌日期_|_复牌日期
停牌时间半年以上	停牌时间半
停牌时间超过3个月复牌的	停牌时间
停牌时间两个月的股票	停牌时间_|_股票
停牌时间是9月19日至10月30日	停牌时间
停牌提示下面的复牌时间准吗	停牌提示下面_|_复牌时间准
停牌条件	停牌条件
停牌原因包含股价异常波动	停牌原因_|_股价异常波动
停牌原因包含交易异常波动	停牌原因_|_交易异常波动
停牌原因是股票交易异常波动	停牌原因_|_股票交易异常波动
停牌原因异常波动	停牌原因异常波动
通达股份庄家持股价格	通达股份_|_庄家持股价格
通鼎互联陈海滨	通鼎互联陈海滨
通过港股通购买港股额度是多少	港股通
通过港股通买的金隅集团的分红什么时候到账	港股通_|_金隅集团
通过港股通怎么买股票	港股通_|_股票
通过港股通账户能够打新	港股通账户
通葡股份庄家利润	通葡股份_|_庄家利润
通润装备庄家筹码多少？	通润装备_|_庄家筹码
通威股份的同行业上市公司有哪些	通威股份_|_上市公司
通威股份庄家持股数量	通威股份_|_庄家持股数量
通威股份庄家持有	通威股份_|_庄家
通信技术行业股权激励现状	通信技术行业_|_股权激励现状
通欲重工有叶飞爆料的股吗	通欲重工_|_叶飞
通裕重工是叶飞概念股吗?	通裕重工_|_叶飞概念股
通裕重工是叶飞慨念股吗?	通裕重工_|_叶飞慨念股
同比是什么意思	同比
同方国信投资控股有限公司	同方国信投资控股有限公司
同行业上市公司有哪些	行业_|_上市公司
同花顺安卓版有庄家抬轿功能，为啥我升级了还是没有	同花顺安卓版_|_庄家抬轿功能
同花顺保险	同花顺_|_保险
同花顺大单异动怎么设置	同花顺_|_大单异动
同花顺港股通支持什么证券公司	同花顺_|_港股通_|_证券公司
同花顺介绍	同花顺
同花顺看不到港股通持仓	同花顺_|_港股通持仓
同花顺可以对股东大会投票吗	同花顺_|_股东大会
同花顺可以交易港股通股票	同花顺_|_港股通股票
同花顺可以开通港股通吗	同花顺_|_港股通
同花顺里面港股通持仓是什么时候更新	同花顺_|_港股通持仓
同花顺里一共有多少家上市公司	同花顺_|_上市公司
同花顺能显示港股通买入股票吗	同花顺_|_港股通_|_股票
同花顺你的异动记录	同花顺_|_异动记录
同花顺全A权重规则	同花顺全A权重规则
同花顺全a指数去年底陆股通持股市值	同花顺全a指数_|_底陆股通持股市值
同花顺如何显示港股通股票	同花顺_|_港股通股票
同花顺软件上可以买入港股通吗	同花顺_|_港股通
同花顺软件中庄家顶底指标的用法	同花顺软件_|_庄家顶底指标
同花顺软件庄家顶底的用法	同花顺软件_|_庄家顶底的用法
同花顺是不是把我交易数据告诉了庄家	同花顺_|_交易数据告_|_庄家
同花顺为什么不能看庄家资金进出	同花顺_|_庄家资金
同花顺相关上市公司有哪些	同花顺_|_上市公司
同花顺异动标准	同花顺异动标准
同花顺有主力异动吗	同花顺_|_主力异动
同花顺有庄家买进吗	同花顺_|_庄家
同花顺在哪里看机构席位	同花顺_|_机构席位
同花顺早盘异动从哪里看	同花顺早盘异动
同花顺怎么开通港股通	同花顺_|_港股通
同花顺怎样看机构席位号	同花顺_|_机构席位号
同花顺庄家何时砸盘	同花顺_|_庄家
同花顺庄家抬轿指标怎么没有？	同花顺_|_庄家抬轿指标
同时3个机构席位买入的个股	机构席位_|_个股
同时为华为和中兴通讯供货的上市公司有哪些	华为_|_中兴通讯_|_上市公司
同时拥有几家上市公司	上市公司
同时拥有几家上市公司的大股东	上市公司_|_大股东
同时拥有几家上市公司的一个大股东	上市公司_|_大股东
同兴达沪深港股通持股量	同兴达_|_沪深港股通持股量
同业拆借利率在哪里看	同业拆借利率
铜峰电子庄家亏损没有	铜峰电子_|_庄家亏损
童锋持	童锋持
投资了商汤科技的上市公司有哪些	商汤科技_|_上市公司
投资柔宇公司的a股上市公司有哪些	投资柔宇公司_|_a股上市公司
投资宇瞳光学的上市公司有哪些	投资宇瞳光学_|_上市公司
突破缺口是怎么形成的	突破缺口
突破双底形态，最近三个月内连续每个月都被被专业机构评级买入，	突破双底形态_|_专业_|_机构
土豪指谁	土豪指谁
退市复牌股票	退市复牌股票
退市股复牌上市股	退市股
拖拉机单是什么	拖拉机单
拓邦股份庄家跑路了吗	拓邦股份_|_庄家
外场什么意思	外场
外汇基金债券的买卖会有庄家活动吗	外汇基金债券_|_庄家
玩叶飞的套路是什么意思	叶飞_|_套路
挽袖线是什么	挽袖线
万芳芳	万芳芳
万锋	万锋
万和电气庄家持有价格是多少	万和电气_|_庄家持有价格
万泰生2019年销售费用占营业总收入的比例	万泰生_|_销售费用_|_营业总收入的比例
万通地产没有庄家了吗	万通地产_|_庄家
万兴科技为什么临时停牌	万兴科技
汪辉武	汪辉武
王德亮	王德亮
王府井近期筹码异动	王府井_|_筹码异动
王府井连续停牌几天	王府井
王富	王富
王富民	王富民
王家的持股价格是多少庄家的持股价格是多少？	王家的持股价格_|_庄家的持股价格
王剑峰的相关介绍	王剑峰
王晶	王晶
王明珍	王明珍
王凝宇	王凝宇
王庆华	王庆华
王淑敏	王淑敏
王万清	王万清
王维东	王维东
王新光了为你监控个股基本面消息面技术面的异动风险	王新光_|_个股基本面_|_消息面_|_技术面
王义平	王义平
王莺妹	王莺妹
王宇翔	王宇翔
王远彬	王远彬
王跃斌	王跃斌
王振东	王振东
王致勤	王致勤
王忠军	王忠军
网上参与公司股东大会投票怎么进行	网上_|_公司_|_股东大会
网易新股能通过港股通购买嘛	网易新股能_|_港股通
微淼商学院——让财务自由不再难	微淼商学院
微芯生物的同行有哪些上市公司	微芯生物_|_上市公司
韦尔股份的股权激励限售股解禁	韦尔股份
韦尔股份股权激励最新消息	韦尔股份_|_最新消息
韦利东	韦利东
韦益红	韦益红
为何机构席位可以买一字板新股	机构席位_|_字板新股
为何没有港股通的股票	港股通_|_股票
为你实施监控个股基本面消息面技术面的异动风险	个股基本面_|_消息面_|_技术面
为你实时监控个股基本面消息面技术面的异动风险	个股基本面_|_消息面_|_技术面
为什么板块会异动	板块
为什么不买庄股	庄股
为什么不要碰庄股	庄股
为什么第一天上市要停牌	
为什么港股通里的钱转不出	港股通
为什么华信国际没有公告就停牌了	华信国际
为什么机构席位可以买一字板新股	机构席位_|_字板新股
为什么交易不了港股通	港股通
为什么今天港股通沪股通流入资金看不到啦	港股通_|_沪股通_|_流入资金
为什么今天没有港股通数据	港股通数据
为什么开股东大会	股东大会
为什么看不到港股通持仓	港股通持仓
为什么看港股通慢十五分钟	港股通
为什么龙溪股份是庄股吗	龙溪股份_|_庄股
为什么没有自选股异动	自选股异动
为什么说这庄股一般都不介入？	庄股
为什么我港股通不能用了	港股通
为什么中兴通讯停牌提示	中兴通讯_|_停牌提示
为什么庄股不能	庄股
为什么庄股不能买	庄股
为什么庄股封单这么	庄股
为什么庄股封单这么少	庄股
为什么庄股就有风险	庄股
为什么庄股是风险股？	庄股_|_风险股
为什么庄股有风险	庄股
为什么庄股允许在A股市场交易，难道没有约束吗？	庄股_|_A股
为什么庄家比散户提前知道消息	庄家比散户_|_知道消息
为什么庄家比想提前知道这么多消息	庄家比想
为什么庄家不来ST股炒	庄家_|_ST股炒
为什么庄家从容出货	庄家
为什么庄家可以操纵股票的价格	庄家_|_股票_|_价格
为什么庄家洗盘资金也流出？	庄家洗盘资金
为什么庄家一直不停的出货	庄家
为特斯拉供货的上市公司有哪些	特斯拉_|_上市公司
唯一下，散户的交易记录，庄家知道吗？	散户_|_交易记录_|_庄家
维康药业的庄家还在里边吗	维康药业_|_庄家
维童今天上市了怎么样停牌呢	维童
维信诺叶飞事件	维信诺_|_叶飞事件
伟新2019年经营计划	伟新_|_经营计划
伟星新材公司基本情况介绍	伟星新材公司基本
伟星新材庄家持仓成夲	伟星新材_|_庄家持仓成夲
尾盘放量是什么意思	尾盘放量
尾盘竞价异动个股	尾盘竞价异动个股
尾盘竞价异动类型为竞价抢筹	尾盘竞价异动类型
尾盘拉升，快速拉升，庄家是为了下一个交易日，高开出货吗	尾盘拉升_|_庄家_|_交易日
尾盘拉升的意义	尾盘拉升
尾盘异动板块在哪看	尾盘异动板块
尾盘异动代表什么	尾盘异动
尾盘异动股票	尾盘异动股票
尾盘异动股怎么选	尾盘异动股
尾盘异动拉升一般代表什么	
尾盘异动如何选股	尾盘异动
委比的含义	委比
委比率的计算公式是什么	委比率_|_计算公式
委比是什么鬼	委比
委托是什么	委托
卫明医药是做什么的	卫明医药
卫宁健康港股通持股数量	卫宁健康港股通持股数量
卫星石化 梅琳达	卫星石化 梅琳达
卫星石化三个月内机构评级”	卫星石化_|_机构
未成交 是什么意思	未成交 
未来全球油气前景	
未来三天即将停牌的公司	公司
味知香公司资料	味知香公司资料
蔚蓝李兴	蔚蓝李兴
蔚蓝锂芯原名是什么	蔚蓝锂芯原名
蔚蓝锂芯庄家多少	蔚蓝锂芯_|_庄家
蔚蓝生物6月8日竞价异动评级	蔚蓝生物_|_竞价异动评级
温氏股份有关的上市公司有哪些	温氏股份_|_上市公司
温州2019年6月股东大会	温州_|_股东大会
温州帮的庄股	温州帮_|_庄股
温州帮是什么意思	温州帮
温州帮庄股	温州帮庄股
文邦英	文邦英
文灿股份有哪些机构评级	文灿股份_|_机构评级
文锋股份公司简介	文锋股份公司
文科园林股东大会相关消息	文科_|_股东大会
闻泰科技有庄股吗	闻泰科技_|_庄股
闻泰科技庄家盈利情况	闻泰科技_|_庄家盈利情况
问财，什么是底部突破颈线位	问财_|_底部突破颈线位
问财什么叫疑似庄股	问财_|_疑似庄股
蜗居生活有哪些上市公司参股	蜗居生活_|_上市公司
我的港股通	港股通
我的港股通成本是人民币还是港币	港股通成本_|_人民币_|_港币
我的港股通持仓看不到	港股通
我的港股通在哪里看	港股通
我的个股异动呢	个股异动呢
我的账户怎么交易不了港股通	账户_|_港股通
我的自选股里有没有庄股	自选股_|_庄股
我的自选股里有庄家的股票	自选股_|_庄家的股票
我的自选股哪些是庄股？	自选股_|_庄股
我的自选股有庄股	自选股_|_庄股
我的自选股有庄股吗	自选股_|_庄股
我附近有哪些上市公司	上市公司
我国历年财政收入	财政收入
我国上市公司股权激励的数量	我国上市公司_|_股权激励的数量
我乐家居2019年年度股东大会	我乐家居_|_年度股东大会
我乐家居今天是庄家出货吗？	我乐家居_|_庄家
我乐家居险资	我乐家居险资
我们常常会听到贝塔系数这个名词，那么贝塔系数是什么意思呢	贝塔系数_|_名词_|_贝塔系数
我们开户的证券公司就是庄家吗	证券公司_|_庄家
我们苏州有几家上市公司	我们苏州_|_上市公司
我是说在股东大会上投这个	股东大会
我问那个002646，是不是庄家有意故意打压洗盘的这个过程	庄家
我已经开通了港股通怎么才能参与打新	港股通
我怎么样知道庄家的成本？	庄家的成本
我自选股里面哪些是庄股	自选股_|_庄股
我昨天买入金逸影视，庄家操盘，如何投诉？	金逸影视_|_庄家操盘
沃森生物有什么机构参与调研	沃森生物_|_机构
邬建斌	邬建斌
邬维静	邬维静
邬晓静	邬晓静
无机构席位与营业部席位卖出的个股	机构席位_|_营业部席位_|_个股
无停牌公告	无停牌公告
无锡的周庄村有哪些上市公司	无锡_|_庄村_|_上市公司
无庄股票特征	股票特征
无庄股有什么特点	无庄股_|_特点
吴光明	吴光明
吴坚	吴坚
吴启超	吴启超
吴通控股是庄家在洗盘嘛	吴通控股_|_庄家
吴伟图	吴伟图
吴卫明	吴卫明
吴限	吴限
吴晓峰	吴晓峰
吴学亮	吴学亮
吴艳	吴艳
吴一凡	吴一凡
吴英	吴英
五大那个五大机构席位红宇新材五大机构席位	五大_|_机构席位_|_机构席位
五发银行代销金额最大的基金	五发银行_|_金额_|_基金
五分钟涨速如何计算	五分钟涨速
五粮液，消费群体	五粮液_|_消费群体
五粮液的庄家仓位	五粮液_|_庄家仓位
五粮液庄家在减持吗	五粮液_|_庄家
五菱宏光的供应链有哪些上市公司	五菱宏光的供应链_|_上市公司
五零的供应商有哪些上市公司	五零_|_供应商_|_上市公司
五穷六绝是什么意思	五穷六绝
五日短线精灵异动个股	五日_|_短线精灵异动个股
五一港股通	港股通
武汉凡谷庄家出货了吗？	武汉凡谷_|_庄家
武汉凡谷庄家数	武汉凡谷_|_庄家数
武汉凡谷庄家盈亏	武汉凡谷_|_庄家盈亏
武汉海佳尔生物医药有限公司关联上市公司有哪些	武汉海佳尔生物医药有限公司_|_上市公司
武汉和襄阳地区上市公司	武汉_|_襄阳地区_|_上市公司
武汉控股现在哪个庄家持有	武汉控股_|_庄家
武汉锐科股东有哪些上市公司	武汉锐科股东_|_上市公司
西安蓝溪科技投资控股有限公司	西安蓝溪科技投资控股有限公司
西部材料庄家出逃了吗？	西部材料_|_庄家
西部建设庄家在洗盘吗	西部建设_|_庄家
西部牧业是不是9月15日起停牌	西部牧业
西部资源复牌能涨吗	西部资源
西藏盛邦控股有限公司	西藏盛邦控股有限公司
西藏天路有没有庄家	西藏天路_|_庄家
西藏药业有庄家进入吗	西藏药业_|_庄家
西藏药业庄家	西藏药业_|_庄家
西陇科学有多少庄家持股	西陇科学_|_庄家持股
西水股份西水股份庄家参与度如何5月17号	西水股份_|_西水股份_|_庄家
西仪股份是否是庄股	西仪股份_|_庄股
吸货是庄家为主么	吸货_|_庄家
吸收合并股票复牌有涨跌幅限制吗	吸收合并股票_|_涨跌幅限制
席位异动的股票	席位_|_股票
席位异动股票	席位异动股票
席位异动股票当日风口	席位异动股票当日风口
下跌中继什么意思	下跌中继
下线长是什么意思	下线长
下一周公司回购股票的有哪些上市公司	公司_|_股票_|_上市公司
下影线比上影线长或没有上影线	下影线_|_上影线
下影线很长是什么意思	下影线很长
下周有哪些上市公司披露业绩	上市公司披露业绩
夏普比率是什么？有什么意义	夏普比率
仙人指路k线是什么	仙人指路_|_k线
仙坛股份是个庄股吗？	仙坛股份_|_庄股
先导智能赛道	先导智能赛道
先锋新材有没有庄家吸筹	先锋新材_|_庄家
显示机构席位买入日期	机构席位_|_买入日期
显示所以港股通可以购买的港股	显示所_|_港股通_|_港股
显示月线KDJ已经超卖是什么意思	KDJ已经超卖
险资持股什么意思	险资持股
险资持股是什么意思	险资持股
险资举牌002195	险资
险资十大股东	险资十大股东
现金等价物怎么算	现金等价物
现金流今个儿解释	现金流今个儿
现金流有什么用	现金流
现在，庄家获利多少	庄家
现在的庄股	庄股
现在的庄家还有谁	庄家
现在该股有庄家吗	庄家
现在科达股份有没庄家洗盘	科达股份_|_庄家
现在上市的公司有多少家	上市的公司
现在盈利最多的庄家是谁	庄家
现在有多少家上市公司	上市公司
现在有哪些股票是庄股	庄股
现在有庄家吗	庄家
现在庄家利润在多	庄家利润
现在庄家是出货还是洗盘	庄家
现在庄家盈利多少	庄家盈利
限制性股票激励计划回购	限制性股票激励计划
限制性股票激励计划回购注销	限制性股票激励计划
限制性股票激励计划激励对象名单	限制性股票激励计划激励对象名单
限制性股票激励计划预留权益失效	限制性股票激励计划_|_预留权益
限制性股权激励股票	限制性_|_股票
相关上市公司有哪些	上市公司
香港中央结算4季度减持港股通净买入个股	港股通_|_个股
香江控股有庄家没	香江控股_|_庄家
祥和实业，庄家还在吗谢谢	祥和实业_|_庄家
向彬	向彬
向下跳空是什么意思	向下跳空
向着庄家！	向着_|_庄家
像长安汽车这样的上市公司有哪些	像长安汽车_|_上市公司
像庄股	像庄股
肖赛平	肖赛平
肖永明	肖永明
消费双十字星庄家进场个股	消费双十字星_|_庄家_|_个股
销售净利率如何计算	销售净利率
销售毛利率什么意思	毛利率
小白炒股了解基本知识	小白炒股
小花怎么样才能触动板块异动啊	小花_|_板块异动
小康股份有庄家买入吗？	小康股份_|_庄家
小米港股通时间	小米港股通时间
小米集团是沪市港股通吗	小米集团_|_沪市港股通
小米加入港股通	小米_|_港股通
小鸟依人什么意思	小鸟依人
小盘潜力庄股	小盘潜力庄股
小盘庄股	小盘庄股
小盘庄股底部	小盘庄股
小盘庄股横盘突破	小盘庄股
小盘庄股买	小盘庄股
小于20元的中小盘庄股	中小盘庄股
小庄和强庄的区别在哪里呀？	小庄_|_强庄
笑露科技的解禁股东有几个	笑露科技_|_解禁股东
协鑫集成庄家如何运作个股	协鑫集成_|_庄家_|_个股
谢宏	谢宏
谢金菱	谢金菱
谢利通	谢利通
芯能科技庄家是收集筹码还是在出货	芯能科技_|_庄家_|_收集筹码
芯片港股通持股市值总市值	港股通持股市值总市值
芯瑞达是否有庄家进入	芯瑞达_|_庄家
欣龙股份庄家在里面吗	欣龙股份_|_庄家
欣龙控股大单买入的庄家	欣龙控股_|_庄家
欣龙控股庄家卖出多少了	欣龙控股_|_庄家
欣旺达有多少庄家在	欣旺达_|_庄家
新澳股份停牌是坏事还是好事	新澳股份
新百都	新百都
新城控股港股通持仓成本	新城控股港股通持仓成本
新大正的股东大会的内容是什么	新大正_|_股东大会
新发债劵的机构评级在哪可以看到？	新发债劵_|_机构
新钢股份盘中异动什么原因	新钢股份_|_盘中异动
新股待上市	新股
新股德业股份停牌	新股德业股份
新股额度计算	新股额
新股份林州了多少啊庄家	新股份_|_庄家
新股何时上市	新股
新股买入时间怎么算	新股
新股盘中停牌条件	新股盘中停牌条件
新股上市大于20天小于150天的非科创板	新股_|_科创板
新股上市科创板	新股_|_科创板
新股什么时间上市	新股
新股市值额度怎么计算	新股市值额度
新股是什么	新股
新股首日停牌	新股
新光金乙特	新光金乙特
新海宜的主力和庄家在什么价位	新海宜_|_主力_|_庄家_|_价位
新和成港股通成交榜	新和成港股通成交榜
新华保险港股通每日额度	新华保险_|_港股通_|_额度
新华通讯社	新华通讯社
新疆火炬复牌会跌停吗	新疆
新疆生产建设兵团农业第五师国有资产监督管理委员会	新疆生产建设兵团农业第五师国有资产监督管理委员会
新洁能，连续三天大跌，是庄家在洗盘吗？	新洁能_|_庄家
新洁能，连续三天大跌是庄家在洗盘吗？	新洁能_|_庄家
新进港股通概念	港股通概念
新进港股通名单	港股通名单
新经济港股通基金有哪些	新经济港股通基金
新开户，佣金是怎么算的	新开户_|_佣金
新丽传媒的控股股东有哪些上市公司	新丽传媒_|_控股股东_|_上市公司
新纳入港股通	港股通
新纳入港股通的股票名单	港股通_|_股票名单
新能源ETF是什么	新能源ETF
新乳业庄家在买入股票	新乳业_|_庄家_|_股票
新三板的上市公司有多少	新三板_|_上市公司
新三板公司股东大会召开日期	新三板公司_|_股东大会_|_日期
新三板股东大会召开时间	新三板_|_股东大会
新三板精选层有多少家上市公司	新三板精选层_|_上市公司
新三板上市公司有多少家	新三板_|_上市公司
新三板是什么	新三板
新三板有多少家上市公司	新三板_|_上市公司
新三板重新上市的公司有哪些	新三板_|_公司
新上市的公司	公司
新上市公司有哪些	新上市公司
新天绿能是做什么	新天绿能
新天然气叶飞	新天然气_|_叶飞
新调入港股通	港股通
新文化庄家是否今天在洗盘	新文化_|_庄家
新五丰有什么庄家	新五丰_|_庄家
新乡化纤庄家数量	新乡化纤_|_庄家数量
新易盛，机构评级买入时间	新易盛_|_机构评级
新增保险公司本期持股数量	新增保险公司_|_本期持股数量
鑫存管是什么	鑫存管
信达地产复牌后会涨还是会跌	信达地产
信达证券没有港股通交易	信达证券_|_港股通
信捷电气是庄家股吗	信捷电气_|_庄家股
信立泰庄家有几	信立泰_|_庄家
信维通信的庄家操作	信维通信_|_庄家
信维通信股权激励行权条件	信维通信_|_股权激励行权条件
信息发展复牌会不会涨	信息发展
星号st是什么意思	星号st
星期六机构评级分布	星期六机构
星期六所属游资派系	星期六所属游资派系
星期六庄家操作k线图	星期六_|_庄家_|_k线图
星期六庄家出逃	星期六_|_庄家
星期六庄家情况	星期六_|_庄家
星期五庄家买的什么票，	星期五_|_庄家
星球石墨控股股东有哪些上市公司	星球石墨控股股东_|_上市公司
星石投资机构什么时候调研的调研603027	星石投资机构
邢美正	邢美正
邢修青	邢修青
邢雁	邢雁
形态解释	形态
兴泸月解禁	
兴森科技怎么操作？有庄家吗？	兴森科技
虚拟成交量是啥意思	虚拟成交量
虚拟货币怎么用	虚拟货币
徐工复牌涨跌幅	徐工_|_涨跌幅
徐工复牌涨跌幅限制	徐工_|_涨跌幅限制
徐工科	徐工科
徐工信息	徐工信息
徐桂芬	徐桂芬
徐家汇庄家进入吗	徐家汇_|_庄家
徐进	
徐素	徐素
徐晓辉	徐晓辉
许广彬	许广彬
许继电气是不是叶飞概念	许继电气_|_叶飞概念
许秀云	许秀云
旭升股份被多少基金调研	旭升股份_|_基金
选股公式详解 哪里下载	选股公式详解
雪迪龙是干什么的	雪迪龙
雪莱特换庄家了	雪莱特换_|_庄家
雪人股份庄家情况	雪人股份_|_庄家
雪天盐业的可比上市公司有哪些	雪天盐业_|_上市公司
压力线	压力线
亚光科技庄家跑了，什么价位止跌	亚光科技_|_庄家
亚辉和	亚辉
亚交所介绍	亚交所
亚普股份有限公司是做什么的	亚普股份有限公司
亚盛集团放量异动	亚盛集团放量异动
亚盛集团有保险吗	亚盛集团_|_保险
亚盛集团庄家是否在收集筹码	亚盛集团_|_庄家_|_筹码
亚世光电参股上市公司有哪些	上市公司
亚夏股份今天有庄家进入吗？	亚夏股份_|_庄家
亚夏汽车重组过会还要停牌吗	亚夏汽车
亚星客车庄家是不是在进场	亚星客车_|_庄家
延安必康股东大会利好还是	延安必康_|_股东大会
延安必康今日散户和庄家比例	延安必康_|_散户_|_庄家比例
延长化建庄家成本平均价	延长化建庄家成本平均价
严圣军	严圣军
研报评级50个亿以下国改地方国改各行业个股目标价	研报评级_|_个股目标价
研报评级买入或增持最多的股票	研报评级_|_股票
研报评级有多少种	研报评级
研报是什么	研报
研究报告评级分类	研究报告评级分类
盐湖提里	盐湖提
盐湖提锂产业链是什么	盐湖提锂产业链
盐湖提锂产业链有啥	盐湖提锂产业链
盐津铺子调研报告	盐津铺子调研报告
颜静刚	颜静刚
兖州煤业股份在港股通可以买吗	兖州煤业股份_|_港股通
央企国资改革是什么意思	央企国资改革
扬杰科技港股通资金流入情况	扬杰科技_|_港股通资金流入情况
阳包阴代表什么	阳包阴
阳光电源新进机构席位	阳光电源_|_机构席位
阳线什么意思	阳线
杨斌	杨斌
杨华均	杨华均
杨建良	杨建良
杨杰30%庄家是30%的利润是什么？	庄家_|_利润
杨杰科技研发费用	杨杰科技_|_研发费用
杨寿海	杨寿海
杨卫东	杨卫东
洋河年报经营情况讨论与分析	洋河年报经营情况讨论
洋河年报经营情况讨论与分析	洋河年报经营情况讨论
姚记科技有多少家机构对它进行调研	姚记科技_|_机构
姚宗宪	姚宗宪
药师帮的a股上市公司有哪些	a股上市公司
要讲国际止盈止损	要讲国际
要退市的上市公司	上市公司
业绩暴涨如何定义	业绩暴涨
业绩的复合增长怎么计算	业绩
业绩高增长庄股暴跌	业绩_|_庄股
业绩高增长庄家出货股	业绩_|_庄家
业绩高增长庄家强庄洗盘	业绩高增长_|_庄家强庄
业绩好机构评级最高的科技股有哪些？	业绩_|_机构_|_科技股
业绩预告规则	业绩预告规则
业绩预告一般多久出	业绩预告
业绩增长100的有哪些上市公司	业绩_|_上市公司
业务是可降解垃圾袋	可降解垃圾袋
叶飞 18	叶飞
叶飞 18股	叶飞
叶飞 giant	叶飞 giant
叶飞 且 流通市值小于100亿	叶飞_|_ 流通市值
叶飞:	叶飞
叶飞;波及个股	叶飞_|_个股
叶飞;涉及19家公司	叶飞_|_公司
叶飞+庄家	叶飞_|_庄家
叶飞18	叶飞
叶飞18个股	叶飞_|_个股
叶飞18个股票	叶飞_|_股票
叶飞18股	叶飞
叶飞18家公司	叶飞18家公司
叶飞18家上市公司	叶飞_|_上市公司
叶飞18只概念	叶飞_|_概念
叶飞18只股票	叶飞_|_股票
叶飞19家个股	叶飞_|_个股
叶飞吧暴雷	叶飞吧暴雷
叶飞板块	叶飞板块
叶飞保管概念股	叶飞保管概念股
叶飞报	叶飞报
叶飞报的十八家公司是哪些公司	叶飞报的十八家公司_|_公司
叶飞报料概念股	叶飞报料概念股
叶飞报料股	叶飞报料股
叶飞报料了那几家公司	叶飞报料_|_公司
叶飞报料那些公司	叶飞报料_|_公司
叶飞暴雷的股票	叶飞_|_股票
叶飞暴雷股	叶飞暴雷股
叶飞暴料股	叶飞暴料股
叶飞爆出的公司	叶飞_|_公司
叶飞爆出市值管理的公司	叶飞_|_市值管理的公司
叶飞爆料的公司	叶飞爆料的公司
叶飞爆料的股票	叶飞_|_股票
叶飞爆料的上市公司	叶飞_|_上市公司
叶飞爆料概念股	叶飞爆料概念股
叶飞爆料个股	叶飞_|_个股
叶飞爆料股	叶飞爆料股
叶飞爆料股票	叶飞爆料股票
叶飞爆料华钰矿业是什么问题?	叶飞爆料华钰矿业
叶飞爆料新闻	叶飞爆料新闻
叶飞爆料影响哪些股票	叶飞_|_股票
叶飞参考个股	叶飞_|_个股
叶飞参与操控个股	叶飞_|_个股
叶飞参与操控个股	叶飞_|_个股
叶飞参与操纵个股排名	叶飞_|_个股排名
叶飞参与的股票	叶飞_|_股票
叶飞操纵个股	叶飞操纵个股
叶飞操纵股票	叶飞操纵股票
叶飞操作的股票有哪些	叶飞_|_股票
叶飞持	叶飞
叶飞持仓的股票	叶飞持仓的股票
叶飞持仓个股	叶飞持仓个股
叶飞持仓股	叶飞持仓股
叶飞持仓股价	叶飞持仓股价
叶飞持股的公司	叶飞持股的公司
叶飞持有的股票	叶飞_|_股票
叶飞持有的股票有哪些	叶飞_|_股票
叶飞持有个股	叶飞_|_个股
叶飞持有个股有那些	叶飞_|_个股
叶飞持有哪些股票	叶飞_|_股票
叶飞的	叶飞
叶飞的18只股	叶飞
叶飞的持仓股票	叶飞_|_持仓股票
叶飞的持股有那些	叶飞_|_持股
叶飞的概念股	叶飞_|_概念股
叶飞的股票	叶飞_|_股票
叶飞的基金公司	叶飞_|_基金公司
叶飞的基金有那些公司	叶飞_|_基金_|_公司
叶飞的十八只股	叶飞
叶飞的套路	叶飞
叶飞点名的18	叶飞
叶飞点名的18只股票名称	叶飞_|_股票
叶飞点名的公司	叶飞_|_公司
叶飞点名股票	叶飞_|_股票
叶飞点名票	叶飞点名票
叶飞反应相关股票	叶飞_|_股票
叶飞风险	叶飞风险
叶飞摡念股	叶飞摡念股
叶飞摡念股有哪些	叶飞摡念股
叶飞概	叶飞概
叶飞概恋股	叶飞概恋股
叶飞概率	叶飞概率
叶飞概念	叶飞概念
叶飞概念。	叶飞概念
叶飞概念;	叶飞概念
叶飞概念+涨停	叶飞概念
叶飞概念+自选股	叶飞概念_|_自选股
叶飞概念18股	叶飞概念18股
叶飞概念产业链	叶飞概念产业链
叶飞概念的自选股	叶飞概念_|_自选股
叶飞概念服	叶飞概念服
叶飞概念个股	叶飞概念个股
叶飞概念公司	叶飞概念公司
叶飞概念股	叶飞概念股
叶飞概念股。	叶飞概念股
叶飞概念股?	叶飞概念股
叶飞概念股都有哪些	叶飞概念股都
叶飞概念股明天会怎样?叶飞概念股明天会如何	叶飞概念股明天会
叶飞概念股票	叶飞概念股票
叶飞概念股票取反	叶飞概念股票取反
叶飞概念股是怎么回事	叶飞概念股
叶飞概念股有哪	叶飞概念股
叶飞概念股有哪些	叶飞概念股
叶飞概念股有哪些?	叶飞概念股
叶飞概念股有那	叶飞概念股
叶飞概念股有那些	叶飞概念股
叶飞概念股有那些票	叶飞概念股
叶飞概念股有一共有多少只	叶飞概念股
叶飞概念股有一共有多少只。	叶飞概念股
叶飞概念取反	叶飞概念取反
叶飞概念是什么概念	叶飞概念
叶飞概念是什么意思?	叶飞概念
叶飞概念剔除	叶飞概念剔除
叶飞概念相关	叶飞概念
叶飞概念相关度百分之80以上	叶飞概念相关度
叶飞概念指数	叶飞概念指数
叶飞个股	叶飞个股
叶飞公布18只股	叶飞
叶飞公布的18家公司	叶飞_|_公司
叶飞公司	叶飞公司
叶飞股	叶飞股
叶飞股票	叶飞股票
叶飞股是什么意思	叶飞股
叶飞关联的股价	叶飞_|_股价
叶飞关联的股票	叶飞_|_股票
叶飞关联公司	叶飞关联公司
叶飞关联股	叶飞关联股
叶飞管理的股票	叶飞管理的股票
叶飞管理的基金	叶飞管理的基金
叶飞管理规模	叶飞管理规模
叶飞管理过的基金	叶飞_|_基金
叶飞黑名单	叶飞黑名单
叶飞黑幕的18家上市公司	叶飞黑幕_|_上市公司
叶飞黑天鹅	叶飞黑天鹅
叶飞基金参与的个股	叶飞基金_|_个股
叶飞讲妖股	叶飞讲妖股
叶飞讲妖股	叶飞讲妖股
叶飞揭露上市公司和机构	叶飞揭露_|_上市公司_|_机构
叶飞举报的18家公司都有哪几家?	叶飞
叶飞举报的股票	叶飞_|_股票
叶飞举报概念	叶飞举报概念
叶飞举报概念股	叶飞举报概念股
叶飞举报了哪些公司	叶飞_|_公司
叶飞慨念	叶飞慨念
叶飞慨念股	叶飞慨念股
叶飞楷念股	叶飞楷念股
叶飞雷概念	叶飞雷概念
叶飞料理	叶飞料理
叶飞买的股票	叶飞_|_股票
叶飞买过的股票	叶飞_|_股票
叶飞买了首航高科吗	叶飞_|_首航高科
叶飞曝光的18家个股	叶飞曝光_|_个股
叶飞曝光的18家公司	叶飞曝光的18家公司
叶飞曝光的公司	叶飞曝光的公司
叶飞曝光的股票	叶飞曝光的股票
叶飞曝光股	叶飞曝光股
叶飞曝光股票	叶飞曝光股票
叶飞曝光相关股票	叶飞曝光相关股票
叶飞券商	叶飞券商
叶飞涉案股	叶飞涉案股
叶飞涉案股票	叶飞涉案股票
叶飞涉及的公司	叶飞_|_公司
叶飞涉及股	叶飞涉及股
叶飞涉及股票	叶飞_|_股票
叶飞涉及券商	叶飞_|_券商
叶飞涉事概念股	叶飞涉事概念股
叶飞什么事	叶飞
叶飞什么事件	叶飞_|_事件
叶飞十八	叶飞
叶飞十八罗汉概念	叶飞十八罗汉概念
叶飞十概念	叶飞十概念
叶飞事	叶飞事
叶飞事件	叶飞事件
叶飞事件的十八支标的	叶飞事件
叶飞事件的相关个股	叶飞事件_|_个股
叶飞事件对股市的影响	叶飞事件
叶飞事件对国信证券有没有影响	叶飞事件_|_国信证券
叶飞事件对哪些股有影响	叶飞事件
叶飞事件对通裕重工的影响	叶飞事件对通裕重工
叶飞事件跟美年有关系吗	叶飞事件
叶飞事件股	叶飞事件股
叶飞事件股票	叶飞事件股票
叶飞事件股票名单	叶飞事件股票名单
叶飞事件会导致短期大风暴	叶飞事件会导致短期大风暴
叶飞事件慨念股	叶飞事件慨念股
叶飞事件涉及哪些上市公司	叶飞事件涉_|_上市公司
叶飞事件是怎么回事	叶飞事件
叶飞事件通裕重工有参与吗	叶飞事件通裕重工
叶飞事件相关个股	叶飞事件_|_个股
叶飞事件相关股	叶飞事件
叶飞事件相关股票	叶飞事件_|_股票
叶飞事件影响大盘	叶飞事件影_|_大盘
叶飞事件影响哪些个	叶飞事件影
叶飞事件影响哪些个股	叶飞事件影_|_个股
叶飞是哪家私募	叶飞_|_私募
叶飞是啥概念	叶飞
叶飞是谁	叶飞
叶飞手握18家上市公司	叶飞_|_上市公司
叶飞手握18家上市公司有那些	叶飞_|_上市公司
叶飞说的18家公司	叶飞_|_公司
叶飞说的18只股票	叶飞_|_股票
叶飞说的股票	叶飞_|_股票
叶飞说的那18只股票是啥	叶飞_|_股票
叶飞说的十八家公司是	叶飞_|_十八家公司
叶飞私募	叶飞私募
叶飞私募冠军直说	叶飞私募冠军直说
叶飞私慕公司名字什么	叶飞私慕公司名字
叶飞私慕什么公	叶飞私慕
叶飞所持股票都有哪些	叶飞所持股票都
叶飞所属概念	叶飞所属概念
叶飞所属概念	叶飞所属概念
叶飞提到的股	叶飞
叶飞提的违规股票	叶飞提_|_违规股票
叶飞提及的股票有哪些	叶飞_|_股票
叶飞挺概念	叶飞挺概念
叶飞投资的股票	叶飞_|_股票
叶飞问	叶飞
叶飞问股	叶飞问股
叶飞问题对中源影响	叶飞_|_中源影响
叶飞相关的18个股票	叶飞_|_股票
叶飞相关股	叶飞
叶飞相关股价	叶飞_|_股价
叶飞相关股票	叶飞_|_股票
叶飞相关基金	叶飞_|_基金
叶飞相关事件关联股	叶飞相关事件
叶飞小市值股市值管理名单	叶飞小市值股市值管理名单
叶飞新闻	叶飞新闻
叶飞新闻有那些	叶飞新闻
叶飞影响	叶飞
叶飞有关哪18家公司?	叶飞_|_公司
叶飞重仓+自选股	叶飞_|_自选股
叶飞庄股	叶飞_|_庄股
叶艳	叶艳
一爱奇艺有关联业务的上市公司有哪些	一爱奇艺_|_上市公司
一般股东大会通过利润分配方案	股东大会_|_利润分配方案
一般庄股多久拉升	庄股
一般庄家从建仓到出货要多长时间才能完成	庄家_|_长时间才能完成
一带一路什么意思	
一方制药有限公司有关上市公司有哪些	一方制药有限公司_|_上市公司
一个点是什么意思	
一个刚上市的上市公司的股价是怎么确定的	上市公司_|_股价
一个月内机构评级买入和增持最多的股票	机构评级_|_股票
一个月内有过买入前5席位中机构席位3个以上的股票	机构席位_|_股票
一根k线的含义	k线
一共有多少家上市公司	上市公司
一级供应商上市公司有哪些	一级供应商_|_上市公司
一键申购是什么意思	
一码通，是什么意思	一码通
一年来机构席位买卖股追踪	机构席位
一年内复牌连板股票	股票
一日港股通调入股票	港股通_|_股票
一是庄股是什么意思？	庄股
一四庄股是什么意思？	一四庄股
一图看懂股权激励	
一线营业部跟买胜率	一线营业部
一线游资跟买胜率	一线游资跟买胜率
一线游资和知名游资的区别	一线游资_|_游资
一线游资是什么人	一线游资
一线游资席位号	一线游资席位号
一线游资与薯名游资区别	一线游资_|_游资
一阳二线意义	一阳二线
一月八日港股通净买入超5000万的股票	港股通_|_股票
一只股票都会有庄家吗	股票都会_|_庄家
一只股票是庄股会怎样	股票_|_庄股
一柱擎天，如何识别庄家	庄家
一庄家持股是	庄家持股
伊利股份的庄家还在不	伊利股份_|_庄家
医美概念是什么内容	医美概念
医美概念详解	医美概念详解
医美行业有哪些上市公司我们的20只	医美行业_|_上市公司
医美是啥意思	医美
医美水光针材料的公司	医美水光针材料_|_公司
医药生物行业上市公司有多少家	医药_|_行业_|_上市公司
医药中间体是什么	医药中间体
依依股份简况	依依股份
依依股份是什么公司	依依股份_|_公司
怡达股份庄家介入了吗	怡达股份_|_庄家
怡球资源还有没有庄家在里面没有	怡球资源_|_庄家
宜通世纪庄家成夲是多少？	宜通世纪_|_庄家成夲
疑似多家机构+顶级游资	疑似_|_机构_|_顶级游资
疑似庄股	疑似庄股
疑似庄股大概有什么股票	疑似庄股_|_股票
疑似庄股的	疑似庄股
疑似庄股的都有哪些	疑似庄股
疑似庄股的个	疑似庄股
疑似庄股的个股	疑似庄股_|_个股
疑似庄股的股票	疑似庄股_|_股票
疑似庄股的股票有哪些	疑似庄股_|_股票
疑似庄股的票	疑似庄股
疑似庄股的意思	疑似庄股
疑似庄股的自选股	疑似庄股_|_自选股
疑似庄股股票	疑似庄股股票
疑似庄股股票有哪些	疑似庄股_|_股票
疑似庄股啥意思	疑似庄股
疑似庄股什么意思	疑似庄股
疑似庄股什么意思；什么叫疑似庄股	疑似庄股_|_疑似庄股
疑似庄股什么意思啊	疑似庄股
疑似庄股是啥意思	疑似庄股
疑似庄股是什么	疑似庄股
疑似庄股是什么意思	疑似庄股
疑似庄股怎么操作	疑似庄股
疑似庄股怎么解释	疑似庄股
疑是庄股什么意思	疑是庄股
疑是庄股是什么意思	疑是庄股
已获利息倍数如何计算	已获利息倍数
已进入转股期是什么意思	已进入转股期
已有a股账户如何开通港股通	a股账户_|_港股通
以岭药业的庄家成	以岭药业_|_庄家成
以前停牌股有哪些	停牌股
以示庄股事件是什么	庄股事件
以太坊是什么	以太坊
亿华通盘前异动	亿华通盘前异动
亿纬锂能庄家减持	亿纬锂能_|_庄家
义乌有营业部吗	营业部
异动板块提示异常	异动板块提示异常
异动标准	异动标准
异动次数	异动次数
异动次数最多的板块	异动次数最多的板块
异动的板块	异动的板块
异动的概念板块	概念板块
异动概念板块	异动概念板块
异动公告标准	异动公告标准
异动功能	异动功能
异动功能在哪	异动功能
异动股提醒	异动股提醒
异动股在哪看	异动股
异动股怎么选	异动股
异动记录板块	异动记录板块
异动记录哪里看	异动记录
异动记录在哪里	异动记录
异动记录怎么没有了	异动记录
异动竞价什么意思	异动竞价
异动拉升的概念	
异动拉升的意思	异动拉升
异动拉升什么意思	异动拉升
异动拉升是什么意思	异动拉升
异动拉升指的什么意思	异动拉升指
异动拉升指什么	异动拉升
异动类型从哪看	异动类型
异动类型的买一剩余大的意思	异动类型
异动类型设置	异动类型
异动类型设置在那里	异动类型
异动类型为竞价抢筹竞价评级看多	异动类型
异动类型有几种	异动类型
异动类型怎么设置	异动类型
异动那里看	异动
异动盘口	异动盘口
异动提醒和风险性提醒有什么区别	异动提醒_|_风险性提醒
异动提醒如何设置	异动提醒
异动提醒是在哪里是	异动提醒
异动提醒在哪	异动提醒
异动提醒在哪看	异动提醒
异动提醒在哪里设置	异动提醒
异动提醒怎么设置	异动提醒
异动提醒怎样设置	异动提醒
异动尾盘	异动尾盘
异动席位	异动席位
异动下挫的股	异动下挫的股
异动下挫个股	异动下挫个股
异动下挫是什么信号	异动下挫
异动语音播报	异动语音播报
异动怎么查	异动
异动怎么看	异动
异动证券股票	异动证券股票
异动指标	异动指标
异动自选	异动自选
易定宏	易定宏
易方达基金调研张坤	易方达基金调研张坤
易方达张坤调研股	易方达张坤调研股
易方达中央汇金是什么	易方达_|_中央汇金
益盟操盘手调研报告	益盟操盘手调研报告
益生股份是强庄股	益生股份_|_强庄股
意华股份最大庄家	意华股份_|_庄家
溢价率是什么	溢价率
翼洪涛	翼洪涛
因赛集团庄家出逃了吗	因赛集团_|_庄家
因重大事件停牌的个股	因重大事件_|_个股
阴包阳意义	阴包阳
银邦股份有庄家么	银邦股份_|_庄家
银邦股份庄家持股成夲多少？	银邦股份_|_庄家持股成夲
银宝山新有没有庄家在	银宝山_|_庄家
银都股份6个月庄家资金	银都股份_|_庄家资金
银河电子没庄家	银河电子_|_庄家
银河金汇东方港湾全称是什么	银河金汇东方港湾
银河证券南京洪五路是哪个机构席位	银河证券南京洪五路_|_机构席位
银山谷的出现意味什么	银山谷
银星能源复牌后上涨概率	银星能源_|_上涨概率
银证转账规则	银证转账规则
英科医疗庄家买入	英科医疗_|_庄家
英唐智控庄家持股情况	英唐智控_|_庄家持股情况
英威腾股权激励条件是多少	英威腾_|_股权激励条件
盈利计算公式	盈利计算公式
盈利率怎么计算	盈利率
盈趣科技主力大单异动	盈趣科技_|_主力
营口港庄家在出货吗	营口港_|_庄家
营业部2月持续大宗交易买入	营业部_|_大宗交易
营业部包含中泰证券	营业部_|_中泰证券
营业部多家买入	营业部
营业部跟买胜率最高	营业部_|_胜率
营业部净额合计占比是什么意思	营业部净额合计占比
营业部类型3日是什么意思	营业部类型
营业部名称包含机构席位买入的个股	营业部_|_机构席位_|_个股
营业部胜率	营业部胜率
营业部胜率排名	营业部胜率排名
营业部胜率最高	营业部胜率
营业部席位是机构席位	营业部席位_|_机构席位
营业部席位与机构席位买入最多的公司	营业部席位_|_机构席位_|_公司
营业部与机构区别	营业部
营营业费用/营业收入	营业费用_|_营业收入
应付票据是什么	应付票据
应付帐款周转天数怎么算	应付帐款周转天数
应该是庄股吧？	庄股
应交税费负重分类是什么意思	应交税费负重分类
应收账款什么意思	应收账款
应收账款周转次数是什么意思	应收账款周转次数
应收账款周转率公式	应收账款周转率公式
拥有核心技术的人工智能的板块的上市公司有哪些	核心技术_|_人工智能_|_板块_|_上市公司
拥有核心技术的上市公司有哪些	核心技术_|_上市公司
永安期货公司的股东有哪些上市公司	永安期货公司_|_股东_|_上市公司
永鼎股份庄家持股占比	永鼎股份_|_庄家持股占比
永辉上次股权激励解禁是	永辉
永泰能源什么时候能上涨？这个股票最近一周也没有庄家介入啊	永泰能源
永新华瑞文化发展有限公司	永新华瑞文化发展有限公司
甬金股份历史交易异常波动	甬金股份_|_交易异常波动
优先股是什么	优先股
邮储银行的机构调研情况	邮储银行_|_机构调研情况
游资百科	游资百科
游资出逃是什么意思	游资出逃
游资的意思	游资
游资跟买胜率	游资跟买胜率
游资和机构是什么意思	游资_|_机构
游资和庄股	游资_|_庄股
游资净买入啥意思	游资净买入
游资净卖出什么意思	游资净卖出
游资什么意思	游资
游资胜率	游资胜率
游资胜率100%	游资胜率
游资胜率最高的	游资胜率
游资是么意思	游资
游资是啥意思	游资
游资是什么机构	游资_|_机构
游资是什么意思	游资
游资是庄家吗	游资_|_庄家
游资席位/2日净流入个股	游资席位_|_个股
游资怎么看	游资
游资章盟主的操作技巧	游资章盟主
游族网络庄股分布	游族网络庄股
友邦吊顶有基金调研嘛	友邦吊顶_|_基金
友达	友达
有板块异动提醒吗	板块异动
有点庄股	庄股
有多少家机构在调研最近	机构
有多少家上市公司	上市公司
有多少家上市公司还没有公布半年报	上市公司_|_年报
有多少家上市公司吗	上市公司
有多少家上市公司一	上市公司
有多少庄家	庄家
有多少庄家持股	庄家持股
有股票异动指标吗	股票异动指标
有股权激励股上市	
有关纯碱的股票	股票
有基金经理调研的公司	基金经理_|_公司
有几家机构席位买入正邦科技	机构席位_|_正邦科技
有几家上市公司	上市公司
有几家上市公司有珠海丽凡达生物公司的股份	上市公司_|_珠海丽凡达生物公司
有减持或庄股吗	庄股
有没有庄家	庄家
有没有庄家啊	庄家
有没有庄家持股？	庄家持股
有没有庄家抬轿指标	庄家抬轿指标
有没有庄家在里面	庄家
有哪些跌破股权激励的股票40%	
有哪些港股通基金	港股通基金
有哪些公司有哪些上市公司持有石药集团的股份	公司_|_上市公司_|_石药集团_|_股份
有哪些上市公司持有北京市科华公司的股份	上市公司_|_北京市科华公司
有哪些上市公司持有光大证券股票	上市公司_|_光大证券股票
有哪些上市公司持有吗?以股份	上市公司
有哪些上市公司发行可转债发行为通过的上市公司有哪些	上市公司_|_可转债_|_上市公司
有哪些上市公司给中芯国际供货	上市公司_|_中芯国际
有哪些上市公司和华大九天有关联	上市公司_|_华大九天
有哪些上市公司是核心资产	上市公司_|_核心资产
有哪些上市公司是农夫山泉的包装供应商	上市公司_|_农夫山泉的包装供应商
有哪些上市公司投资浪潮云	上市公司投资浪潮云
有哪些上市公司有参股中国国新	上市公司_|_中国国新
有哪些上市公司与中芯国际合作	上市公司_|_中芯国际
有哪些是疑似庄股	疑似庄股
有哪些像庄股	庄股
有哪些庄股股票？	庄股股票
有强庄的，相对低位。	强庄
有强庄么？	强庄
有上影线和下影线的	上影线_|_下影线
有上影线与下影线	上影线_|_下影线
有什么庄股	庄股
有私募调研海伦钢琴没	私募_|_海伦钢琴
有温州庄家吗	温州_|_庄家
有无庄家	庄家
有芯片的核心技术的上市公司有哪些	核心技术_|_上市公司
有新疆茅台酒之称的是什么意思	新疆茅台酒
有新年上市公司有哪些	上市公司
有研新材今天庄家出货了吗？	有研新材_|_庄家
有疑似庄股的个股	疑似庄股_|_个股
有异动语音播报吗	异动语音播报
有游资的股票和庄股有什么区别	游资_|_股票_|_庄股
有有哪些股票是庄股	庄股
有在香港上市	
